1111111111111111111111111111111111
1E0000V00000000C00000C000000000001
100000000V000000000000000000010101
1010010010101010001001000000010101
1P0000000C00C000000000000V000000C1
1111111111111111111111111111111111