111111111111111111111111111111111111111
1P00000001000V00000000000000000000000C1
100000000100000000000000100000000010001
1000V000010000000000000010000V000010001
10000000010000000000V000100000000010001
100000000100000000000000100000000010001
100000000000000000000000C00000000C100E1
111111111111111111111111111111111111111