1111111111111
10000V0000V01
100V011110C01
1P001100E0101
1111111111111